    " ###############################",
    "#_____________________________#",
    "#______#__________####________#",
    "#______#__________#___________#",
    "#______######______#__________#",
    "#__________________#__________#",
    "#__________________#__________#",
    "#______######______#__________#",
    "#______#__________#___________#",
    "#______#__________####________#",
    "#_____________________________#",
    "###############################",
