######################################################################
#_______#__________#_____________________________#___________#_______#
#___#_________#_________#_________________#______#_#__#____________#_#
#__#______#__________#_______________________________________________#
##_______#__________#______#_#______________#____________#__#______#_#
#_#__________#_____________________________#____________#____________#
#__#_____________#_____#____________#_____________#______#___#_______#
#____###____#________#__________#___________#_____________#__________#
#_______________________________#______#________________##___________#
#________#______#___#__________#_________#___________________________#
#__#__#_______________#_____________#___##____#__________#___#_______#
#______#____#____#____#___________________#_#______________#_________#
#______#_____#_________________#_____________________##______________#
#___________________#_________#________________#____#________________#
#__________#_____________#______#______#___#_________________#_______#
##________________#_#______________#______________#__________________#
#_____#____#__#_____________________#__#_#____#_______________#______#
#_________#_______________________________#____________#________#____#
#_________#_#____________________#____#______#_______________________#
#______________#_______________________________###___________#_#_____#
#_#__________________________#___#__#_________________#___________#__#
#___#_#_________________________#___#______________________________###
#__________#_#___________________#_#_________##_#___________________##
#________#___________________#___________#__#____#__#________________#
#__________________##______________#_#__#__________#______#__#_______#
#_____________________________________________________________#_#____#
#____#_______________#_______________________________#___#___________#
#____#__________________________________________________________#____#
#___#_______#_________________________##____#__________#_#__##___#___#
#____________#____#_________#_______________#________________________#
#_________________##____________________________#______##_______#____#
##_#__________#______________________________#___#____#_#____________#
######################################################################