   " ####################",
    "#__________________#",
    "#____########______#",
    "#____########______#",
    "#____########______#",
    "#__________________#",
    "####################",
]