    " ############# # ###############",
    "#___________________________#",
    "#______#__________####______#",
    "#______#__________#_________#",
    "#______######______#________#",
    "#__________________#________#",
    "#__________________#________#",
    "#______######______#________#",
    "#______#__________#_________#",
    "#______#__________####______#",
    "#___________________________#",
    "#############################",
