########################################################################
#_##____#_______________#_______#_#____#____#_#_##___#________#______#_#
#_______________#____________#___#__#__#____##___#__#_____#____#___#___#
#_##__#__________#___#_#_#_#____#_____#_#_#______________#_#___________#
#______#_____##___________#_#_#_#___#_________#________________#___#___#
#__#_###_________#_________#_#__#____#_#_#__#____#____#_##_##_#____#___#
#__#___#____#__#_###__#__________#____#___#____###___#___###____#_____##
#______#____#__#__##_#______#__#__#____#___##_#_______#________________#
##_______##_#__#__________#_________________##_________________________#
#____#_____#_____________#___#__#__________##_#__________#________##___#
####____#_____##___#__________#____#_#______________#___#_____________##
#_#___##______##____###_______##_______#_##____#__##_#____________#_##_#
#_#____#______#______#______________#__##______#_#_____#____#_____###__#
#_#__##___#__#____#_____#____#__#_#______#__#______#__#______#___#_____#
#____##_#_#___#__________#_#_____##__##___#_#__#______#____#__#_#____#_#
#______________#___#_#______________#____________________##___#__#_____#
#__#_##__#_#__#_##____#_____#__#_#___#__________#_____________#_#______#
#____#___#____#______#________#____________#_________________#_____#___#
#______##_____##__________________#___###__________#___##___#____#__####
#____#_________#_#____________##___________#__#__#______##_____#_____#_#
#__#__#_____#___#________#_____#___________#_#______#_________#__#_____#
#__________#____#__________________________#_____________#______#______#
#_#__#_________##___#___________#_#_____________##__#__#____#__________#
#__#________________#__#_#_______#_#_____________#_#______#_____#______#
##______#_________###_________#__#___#____#_#___#_##______#__#______#__#
#___#__#####_____#__#_#_______##_____#_##__#__##_#___#__#_________#____#
#__#_____#_##____________________#___#_#___#___#_____#_____##____##___##
#__#_#_____#___#__##_##_#___#________________#__#____#_____#_#____#__###
#____#_______##______##__#_________#_#______#__#____#__#_#___#__#___#__#
#________#______#____#__#_____________________________#_______##__#__###
#__#_________###_#___#_______##__#___#___________#__#_______________#__#
#__##_______#_#____#___________#_#_____#____#_#________#_##__#________##
#_______#__#______________#_____________#_____###___#_____#_#_#___#__#_#
#__#_#___#_#_#______#__#__#___#_#__#___#__#__________#__#_____#__#____##
########################################################################